############################################
##################                     #####
######                ###############  #####
######  #########################      #####
######  #########################  #########
#######              ############  #########
#################### ############  #########
######   ########    ######          #######
########  ####### ################## #######
#######     #####       ######          ####
##########  ########### ############### ####
##########      #######                 ####
############  ##############################
############              @  ###############
############################################